aba - Aba
abadszalok - Abádszalók
abaliget - Abaliget
abasar - Abasár
abaujalpar - Abaújalpár
abaujker - Abaújkér
abaujlak - Abaújlak
abaujszanto - Abaújszántó
abaujszolnok - Abaújszolnok
abaujvar - Abaújvár
abda - Abda
abod - Abod
abony - Abony
abrahamhegy - Ábrahámhegy
acs - Ács
acsa - Acsa
acsad - Acsád
acsalag - Acsalag
acsteszer - Ácsteszér
adacs - Adács
adand - Ádánd
adasztevel - Adásztevel
adony - Adony
adorjanhaza - Adorjánháza
adorjas - Adorjás
ag - Ág
agasegyhaza - Ágasegyháza
agfalva - Ágfalva
aggtelek - Aggtelek
agyagosszergeny - Agyagosszergény
ajak - Ajak
ajka - Ajka
aka - Aka
akaszto - Akasztó
alacska - Alacska
alap - Alap
alattyan - Alattyán
albertirsa - Albertirsa
alcsutdoboz - Alcsútdoboz
aldebro - Aldebrő
algyo - Algyő
alibanfa - Alibánfa
almamellek - Almamellék
almasfuzito - Almásfüzitő
almashaza - Almásháza
almaskamaras - Almáskamarás
almaskeresztur - Almáskeresztúr
almosd - Álmosd
alsoberecki - Alsóberecki
alsobogat - Alsóbogát
alsodobsza - Alsódobsza
alsogagy - Alsógagy
alsomocsolad - Alsómocsolád
alsonana - Alsónána
alsonemedi - Alsónémedi
alsonemesapati - Alsónemesapáti
alsonyek - Alsónyék
alsoors - Alsóörs
alsopahok - Alsópáhok
alsopeteny - Alsópetény
alsorajk - Alsórajk
alsoregmec - Alsóregmec
alsoszenterzsebet - Alsószenterzsébet
alsoszentivan - Alsószentiván
alsoszentmarton - Alsószentmárton
alsoszolnok - Alsószölnök
alsoszuha - Alsószuha
alsotelekes - Alsótelekes
alsotold - Alsótold
alsoujlak - Alsóújlak
alsovadasz - Alsóvadász
alsozsolca - Alsózsolca
ambrozfalva - Ambrózfalva
anarcs - Anarcs
andocs - Andocs
andornaktalya - Andornaktálya
andrasfa - Andrásfa
annavolgy - Annavölgy
apacatorna - Apácatorna
apagy - Apagy
apaj - Apaj
aparhant - Aparhant
apatfalva - Apátfalva
apatistvanfalva - Apátistvánfalva
apatvarasd - Apátvarasd
apc - Apc
aporka - Áporka
apostag - Apostag
aranyosapati - Aranyosapáti
aranyosgadany - Aranyosgadány
arka - Arka
arlo - Arló
arnot - Arnót
arokto - Ároktő
arpadhalom - Árpádhalom
arpas - Árpás
artand - Ártánd
asotthalom - Ásotthalom
asvanyraro - Ásványráró
aszalo - Aszaló
aszar - Ászár
aszod - Aszód
aszofo - Aszófő
ata - Áta
atany - Átány
atkar - Atkár
attala - Attala
babarc - Babarc
babarcszolos - Babarcszőlős
babocsa - Babócsa
babolna - Bábolna
babonymegyer - Bábonymegyer
babosdobrete - Babosdöbréte
babot - Babót
bacsalmas - Bácsalmás
bacsbokod - Bácsbokod
bacsborsod - Bácsborsód
bacsszentgyorgy - Bácsszentgyörgy
bacsszolos - Bácsszőlős
badacsonytomaj - Badacsonytomaj
badacsonytordemic - Badacsonytördemic
bag - Bag
bagamer - Bagamér
baglad - Baglad
bagod - Bagod
bagyogszovat - Bágyogszovát
baj - Baj
baja - Baja
bajansenye - Bajánsenye
bajna - Bajna
bajot - Bajót
bak - Bak
bakhaza - Bakháza
bakoca - Bakóca
bakonszeg - Bakonszeg
bakonya - Bakonya
bakonybank - Bakonybánk
bakonybel - Bakonybél
bakonycsernye - Bakonycsernye
bakonygyirot - Bakonygyirót
bakonyjako - Bakonyjákó
bakonykoppany - Bakonykoppány
bakonykuti - Bakonykúti
bakonynana - Bakonynána
bakonyoszlop - Bakonyoszlop
bakonypeterd - Bakonypéterd
bakonypoloske - Bakonypölöske
bakonysag - Bakonyság
bakonysarkany - Bakonysárkány
bakonyszentivan - Bakonyszentiván
bakonyszentkiraly - Bakonyszentkirály
bakonyszentlaszlo - Bakonyszentlászló
bakonyszombathely - Bakonyszombathely
bakonyszucs - Bakonyszücs
bakonytamasi - Bakonytamási
baks - Baks
baksa - Baksa
baktakek - Baktakék
baktaloranthaza - Baktalórántháza
baktuttos - Baktüttös
balajt - Balajt
balassagyarmat - Balassagyarmat
balastya - Balástya
balaton - Balaton
balatonakali - Balatonakali
balatonakarattya - Balatonakarattya
balatonalmadi - Balatonalmádi
balatonbereny - Balatonberény
balatonboglar - Balatonboglár
balatoncsicso - Balatoncsicsó
balatonederics - Balatonederics
balatonendred - Balatonendréd
balatonfenyves - Balatonfenyves
balatonfokajar - Balatonfőkajár
balatonfoldvar - Balatonföldvár
balatonfured - Balatonfüred
balatonfuzfo - Balatonfűzfő
balatongyorok - Balatongyörök
balatonhenye - Balatonhenye
balatonkenese - Balatonkenese
balatonkeresztur - Balatonkeresztúr
balatonlelle - Balatonlelle
balatonmagyarod - Balatonmagyaród
balatonmariafurdo - Balatonmáriafürdő
balatonoszod - Balatonőszöd
balatonrendes - Balatonrendes
balatonszabadi - Balatonszabadi
balatonszarszo - Balatonszárszó
balatonszemes - Balatonszemes
balatonszentgyorgy - Balatonszentgyörgy
balatonszepezd - Balatonszepezd
balatonszolos - Balatonszőlős
balatonudvari - Balatonudvari
balatonujlak - Balatonújlak
balatonvilagos - Balatonvilágos
balinka - Balinka
balkany - Balkány
balloszog - Ballószög
balmazujvaros - Balmazújváros
balogunyom - Balogunyom
balotaszallas - Balotaszállás
balsa - Balsa
balvanyos - Bálványos
bana - Bana
band - Bánd
banfa - Bánfa
banhorvati - Bánhorváti
bank - Bánk
banokszentgyorgy - Bánokszentgyörgy
banreve - Bánréve
bar - Bár
barabas - Barabás
baracs - Baracs
baracska - Baracska
barand - Báránd
baranyahidveg - Baranyahídvég
baranyajeno - Baranyajenő
baranyaszentgyorgy - Baranyaszentgyörgy
barbacs - Barbacs
barcs - Barcs
bardudvarnok - Bárdudvarnok
barlahida - Barlahida
barna - Bárna
barnag - Barnag
barsonyos - Bársonyos
basal - Basal
basko - Baskó
bata - Báta
bataapati - Bátaapáti
bataszek - Bátaszék
bate - Baté
batmonostor - Bátmonostor
batonyterenye - Bátonyterenye
bator - Bátor
batorliget - Bátorliget
battonya - Battonya
batya - Bátya
batyk - Batyk
bazakerettye - Bázakerettye
bazsi - Bazsi
beb - Béb
becsehely - Becsehely
becske - Becske
becskehaza - Becskeháza
becsvolgye - Becsvölgye
bedegker - Bedegkér
bedo - Bedő
bejcgyertyanos - Bejcgyertyános
bekas - Békás
bekecs - Bekecs
bekes - Békés
bekescsaba - Békéscsaba
bekessamson - Békéssámson
bekesszentandras - Békésszentandrás
bekolce - Bekölce
belapatfalva - Bélapátfalva
belavar - Bélavár
belecska - Belecska
beled - Beled
beleg - Beleg
belezna - Belezna
belmegyer - Bélmegyer
beloiannisz - Beloiannisz
belsosard - Belsősárd
belvardgyula - Belvárdgyula
benk - Benk
benye - Bénye
ber - Bér
berbaltavar - Bérbaltavár
bercel - Bercel
beregdaroc - Beregdaróc
beregsurany - Beregsurány
berekboszormeny - Berekböszörmény
berekfurdo - Berekfürdő
beremend - Beremend
berente - Berente
beret - Beret
berettyoujfalu - Berettyóújfalu
berhida - Berhida
berkenye - Berkenye
berkesd - Berkesd
berkesz - Berkesz
bernecebarati - Bernecebaráti
berzek - Berzék
berzence - Berzence
besence - Besence
besenyod - Besenyőd
besenyotelek - Besenyőtelek
besenyszog - Besenyszög
besnyo - Besnyő
beszterec - Beszterec
bezedek - Bezedek
bezenye - Bezenye
bezered - Bezeréd
bezi - Bezi
biatorbagy - Biatorbágy
bicserd - Bicsérd
bicske - Bicske
bihardancshaza - Bihardancsháza
biharkeresztes - Biharkeresztes
biharnagybajom - Biharnagybajom
bihartorda - Bihartorda
biharugra - Biharugra
bikacs - Bikács
bikal - Bikal
biri - Biri
birjan - Birján
bisse - Bisse
boba - Boba
bocfolde - Bocfölde
boconad - Boconád
bocsa - Bócsa
bocska - Bocska
bocskaikert - Bocskaikert
boda - Boda
bodajk - Bodajk
bodmer - Bodmér
bodolyaber - Bodolyabér
bodonhely - Bodonhely
bodony - Bodony
bodorfa - Bodorfa
bodrog - Bodrog
bodroghalom - Bodroghalom
bodrogkeresztur - Bodrogkeresztúr
bodrogkisfalud - Bodrogkisfalud
bodrogolaszi - Bodrogolaszi
bodvalenke - Bódvalenke
bodvarako - Bódvarákó
bodvaszilas - Bódvaszilas
bogacs - Bogács
bogad - Bogád
bogadmindszent - Bogádmindszent
bogdasa - Bogdása
bogyiszlo - Bogyiszló
bogyoszlo - Bogyoszló
bojt - Bojt
bokahaza - Bókaháza
bokod - Bokod
bokor - Bokor
boldog - Boldog
boldogasszonyfa - Boldogasszonyfa
boldogkoujfalu - Boldogkőújfalu
boldogkovaralja - Boldogkőváralja
boldva - Boldva
bolhas - Bolhás
bolho - Bolhó
boly - Bóly
boncodfolde - Boncodfölde
bonyhad - Bonyhád
bonyhadvarasd - Bonyhádvarasd
bonnya - Bonnya
bordany - Bordány
borgata - Borgáta
borjad - Borjád
borota - Borota
borsfa - Borsfa
borsodbota - Borsodbóta
borsodgeszt - Borsodgeszt
borsodivanka - Borsodivánka
borsodnadasd - Borsodnádasd
borsodszentgyorgy - Borsodszentgyörgy
borsodszirak - Borsodszirák
borsosbereny - Borsosberény
borszorcsok - Borszörcsök
borzavar - Borzavár
bosta - Bosta
botpalad - Botpalád
botykapeterd - Botykapeterd
bozzai - Bozzai
bozsok - Bozsok
bozsva - Bózsva
bo - Bő
bocs - Bőcs
bode - Böde
bodehaza - Bödeháza
bogot - Bögöt
bogote - Bögöte
bohonye - Böhönye
bokony - Bököny
bolcske - Bölcske
bony - Bőny
borcs - Börcs
borzonce - Börzönce
bosarkany - Bősárkány
boszenfa - Bőszénfa
bucsa - Bucsa
bucsu - Bucsu
bucsuszentlaszlo - Búcsúszentlászló
bucsuta - Bucsuta
budajeno - Budajenő
budakalasz - Budakalász
budakeszi - Budakeszi
budaors - Budaörs
budapest - Budapest
budapest-01-ker - Budapest 01. ker.
budapest-02-ker - Budapest 02. ker.
budapest-03-ker - Budapest 03. ker.
budapest-04-ker - Budapest 04. ker.
budapest-05-ker - Budapest 05. ker.
budapest-06-ker - Budapest 06. ker.
budapest-07-ker - Budapest 07. ker.
budapest-08-ker - Budapest 08. ker.
budapest-09-ker - Budapest 09. ker.
budapest-10-ker - Budapest 10. ker.
budapest-11-ker - Budapest 11. ker.
budapest-12-ker - Budapest 12. ker.
budapest-13-ker - Budapest 13. ker.
budapest-14-ker - Budapest 14. ker.
budapest-15-ker - Budapest 15. ker.
budapest-16-ker - Budapest 16. ker.
budapest-17-ker - Budapest 17. ker.
budapest-18-ker - Budapest 18. ker.
budapest-19-ker - Budapest 19. ker.
budapest-20-ker - Budapest 20. ker.
budapest-21-ker - Budapest 21. ker.
budapest-22-ker - Budapest 22. ker.
budapest-23-ker - Budapest 23. ker.
bugac - Bugac
bugacpusztahaza - Bugacpusztaháza
bugyi - Bugyi
buj - Buj
bujak - Buják
buzsak - Buzsák
buk - Bük
bukkabrany - Bükkábrány
bukkaranyos - Bükkaranyos
bukkmogyorosd - Bükkmogyorósd
bukkosd - Bükkösd
bukkszek - Bükkszék
bukkszenterzsebet - Bükkszenterzsébet
bukkszentkereszt - Bükkszentkereszt
bukkszentmarton - Bükkszentmárton
bukkzserc - Bükkzsérc
burus - Bürüs
bussu - Büssü
buttos - Büttös
cak - Cák
cakohaza - Cakóháza
cece - Cece
cegenydanyad - Cégénydányád
cegled - Cegléd
cegledbercel - Ceglédbercel
celldomolk - Celldömölk
cered - Cered
chernelhazadamonya - Chernelházadamonya
cibakhaza - Cibakháza
cigand - Cigánd
ciko - Cikó
cirak - Cirák
cun - Cún
csabacsud - Csabacsűd
csabaszabadi - Csabaszabadi
csabdi - Csabdi
csabrendek - Csabrendek
csafordjanosfa - Csáfordjánosfa
csaholc - Csaholc
csajag - Csajág
csakany - Csákány
csakanydoroszlo - Csákánydoroszló
csakbereny - Csákberény
csakvar - Csákvár
csanadalberti - Csanádalberti
csanadapaca - Csanádapáca
csanadpalota - Csanádpalota
csanig - Csánig
csany - Csány
csanyoszro - Csányoszró
csanytelek - Csanytelek
csapi - Csapi
csapod - Csapod
csardaszallas - Csárdaszállás
csarnota - Csarnóta
csaroda - Csaroda
csaszar - Császár
csaszartoltes - Császártöltés
csaszlo - Császló
csatalja - Csátalja
csatar - Csatár
csataszog - Csataszög
csatka - Csatka
csavoly - Csávoly
csebeny - Csebény
csecse - Csécse
csegold - Csegöld
csehbanya - Csehbánya
csehi - Csehi
csehimindszent - Csehimindszent
csem - Csém
csemo - Csemő
csempeszkopacs - Csempeszkopács
csengele - Csengele
csenger - Csenger
csengersima - Csengersima
csengerujfalu - Csengerújfalu
csengod - Csengőd
csenye - Csénye
csenyete - Csenyéte
csep - Csép
csepa - Csépa
csepreg - Csepreg
cser - Csér
cserdi - Cserdi
cserenfa - Cserénfa
cserepfalu - Cserépfalu
cserepvaralja - Cserépváralja
cserhathalap - Cserháthaláp
cserhatsurany - Cserhátsurány
cserhatszentivan - Cserhátszentiván
cserkeszolo - Cserkeszőlő
cserkut - Cserkút
csernely - Csernely
cserszegtomaj - Cserszegtomaj
csertalakos - Csertalakos
cserto - Csertő
csesznek - Csesznek
csesztreg - Csesztreg
csesztve - Csesztve
cseteny - Csetény
csevharaszt - Csévharaszt
csibrak - Csibrák
csikeria - Csikéria
csikostottos - Csikóstőttős
csikvand - Csikvánd
csincse - Csincse
csipkerek - Csipkerek
csitar - Csitár
csobad - Csobád
csobaj - Csobaj
csobanka - Csobánka
csokako - Csókakő
csokonyavisonta - Csokonyavisonta
csokvaomany - Csokvaomány
csolnok - Csolnok
csolyospalos - Csólyospálos
csoma - Csoma
csomad - Csomád
csombard - Csombárd
csongrad - Csongrád
csonkahegyhat - Csonkahegyhát
csonkamindszent - Csonkamindszent
csopak - Csopak
csor - Csór
csorna - Csorna
csorvas - Csorvás
csot - Csót
csode - Csöde
csogle - Csögle
csokmo - Csökmő
csokoly - Csököly
csomend - Csömend
csomoder - Csömödér
csomor - Csömör
csonge - Csönge
csornyefold - Csörnyeföld
csorog - Csörög
csorotnek - Csörötnek
csosz - Csősz
csovar - Csővár
csurgo - Csurgó
csurgonagymarton - Csurgónagymarton
dabas - Dabas
dabronc - Dabronc
dabrony - Dabrony
dad - Dad
dag - Dág
daka - Dáka
dalmand - Dalmand
damak - Damak
damoc - Dámóc
danszentmiklos - Dánszentmiklós
dany - Dány
daraboshegy - Daraboshegy
darany - Darány
darno - Darnó
darnozseli - Darnózseli
daruszentmiklos - Daruszentmiklós
darvas - Darvas
davod - Dávod
debercseny - Debercsény
debrecen - Debrecen
debrete - Debréte
decs - Decs
dedestapolcsany - Dédestapolcsány
deg - Dég
dejtar - Dejtár
delegyhaza - Délegyháza
demecser - Demecser
demjen - Demjén
dencshaza - Dencsháza
denesfa - Dénesfa
derecske - Derecske
derekegyhaz - Derekegyház
deszk - Deszk
detek - Detek
detk - Detk
devavanya - Dévaványa
devecser - Devecser
dinnyeberki - Dinnyeberki
diosbereny - Diósberény
diosd - Diósd
diosjeno - Diósjenő
dioskal - Dióskál
diosviszlo - Diósviszló
doba - Doba
doboz - Doboz
dobri - Dobri
dobronhegy - Dobronhegy
doc - Dóc
domahaza - Domaháza
domaszek - Domaszék
dombegyhaz - Dombegyház
dombiratos - Dombiratos
dombovar - Dombóvár
dombrad - Dombrád
domony - Domony
domoszlo - Domoszló
dormand - Dormánd
dorog - Dorog
doroghaza - Dorogháza
dozmat - Dozmat
doborhegy - Döbörhegy
dobroce - Döbröce
dobrokoz - Döbrököz
dobronte - Döbrönte
doge - Döge
domos - Dömös
domsod - Dömsöd
dor - Dör
dorgicse - Dörgicse
doroske - Döröske
dotk - Dötk
doveny - Dövény
dragszel - Drágszél
dravacsehi - Drávacsehi
dravacsepely - Drávacsepely
dravafok - Drávafok
dravagardony - Drávagárdony
dravaivanyi - Drávaiványi
dravakeresztur - Drávakeresztúr
dravapalkonya - Drávapalkonya
dravapiski - Drávapiski
dravaszabolcs - Drávaszabolcs
dravaszerdahely - Drávaszerdahely
dravasztara - Drávasztára
dravatamasi - Drávatamási
dregelypalank - Drégelypalánk
dubicsany - Dubicsány
dudar - Dudar
duka - Duka
dunaalmas - Dunaalmás
dunabogdany - Dunabogdány
dunaegyhaza - Dunaegyháza
dunafalva - Dunafalva
dunafoldvar - Dunaföldvár
dunaharaszti - Dunaharaszti
dunakeszi - Dunakeszi
dunakiliti - Dunakiliti
dunapataj - Dunapataj
dunaremete - Dunaremete
dunaszeg - Dunaszeg
dunaszekcso - Dunaszekcső
dunaszentbenedek - Dunaszentbenedek
dunaszentgyorgy - Dunaszentgyörgy
dunaszentmiklos - Dunaszentmiklós
dunaszentpal - Dunaszentpál
dunasziget - Dunasziget
dunatetetlen - Dunatetétlen
dunaujvaros - Dunaújváros
dunavarsany - Dunavarsány
dunavecse - Dunavecse
dusnok - Dusnok
duzs - Dúzs
ebergoc - Ebergőc
ebes - Ebes
ecs - Écs
ecsed - Ecséd
ecseg - Ecseg
ecsegfalva - Ecsegfalva
ecseny - Ecseny
ecser - Ecser
edde - Edde
edeleny - Edelény
edve - Edve
eger - Eger
egerag - Egerág
egeralja - Egeralja
egeraracsa - Egeraracsa
egerbakta - Egerbakta
egerbocs - Egerbocs
egercsehi - Egercsehi
egerfarmos - Egerfarmos
egerlovo - Egerlövő
egerszalok - Egerszalók
egerszolat - Egerszólát
egerszog - Égerszög
egervar - Egervár
egervolgy - Egervölgy
egyed - Egyed
egyek - Egyek
egyhazasdengeleg - Egyházasdengeleg
egyhazasfalu - Egyházasfalu
egyhazasgerge - Egyházasgerge
egyhazasharaszti - Egyházasharaszti
egyhazashetye - Egyházashetye
egyhazashollos - Egyházashollós
egyhazaskeszo - Egyházaskesző
egyhazaskozar - Egyházaskozár
egyhazasradoc - Egyházasrádóc
elek - Elek
ellend - Ellend
eloszallas - Előszállás
emod - Emőd
encs - Encs
encsencs - Encsencs
endrefalva - Endrefalva
endroc - Endrőc
enese - Enese
enying - Enying
eperjes - Eperjes
eperjeske - Eperjeske
epleny - Eplény
epol - Epöl
ercsi - Ercsi
erd - Érd
erdobenye - Erdőbénye
erdohorvati - Erdőhorváti
erdokertes - Erdőkertes
erdokovesd - Erdőkövesd
erdokurt - Erdőkürt
erdosmarok - Erdősmárok
erdosmecske - Erdősmecske
erdotarcsa - Erdőtarcsa
erdotelek - Erdőtelek
erk - Erk
erpatak - Érpatak
ersekcsanad - Érsekcsanád
ersekhalma - Érsekhalma
ersekvadkert - Érsekvadkert
erteny - Értény
erzsebet - Erzsébet
esztar - Esztár
eszteregnye - Eszteregnye
esztergalyhorvati - Esztergályhorváti
esztergom - Esztergom
ete - Ete
etes - Etes
etyek - Etyek
fabianhaza - Fábiánháza
fabiansebestyen - Fábiánsebestyén
facankert - Fácánkert
fadd - Fadd
faj - Fáj
fajsz - Fajsz
fancsal - Fancsal
farad - Farád
farkasgyepu - Farkasgyepű
farkaslyuk - Farkaslyuk
farmos - Farmos
fazekasboda - Fazekasboda
fedemes - Fedémes
fegyvernek - Fegyvernek
fehergyarmat - Fehérgyarmat
feherto - Fehértó
fehervarcsurgo - Fehérvárcsurgó
feked - Feked
feketeerdo - Feketeerdő
felcsut - Felcsút
feldebro - Feldebrő
felgyo - Felgyő
felpec - Felpéc
felsoberecki - Felsőberecki
felsocsatar - Felsőcsatár
felsodobsza - Felsődobsza
felsoegerszeg - Felsőegerszeg
felsogagy - Felsőgagy
felsojanosfa - Felsőjánosfa
felsokelecseny - Felsőkelecsény
felsolajos - Felsőlajos
felsomarac - Felsőmarác
felsomocsolad - Felsőmocsolád
felsonana - Felsőnána
felsonyarad - Felsőnyárád
felsonyek - Felsőnyék
felsoors - Felsőörs
felsopahok - Felsőpáhok
felsopakony - Felsőpakony
felsopeteny - Felsőpetény
felsorajk - Felsőrajk
felsoregmec - Felsőregmec
felsoszenterzsebet - Felsőszenterzsébet
felsoszentivan - Felsőszentiván
felsoszentmarton - Felsőszentmárton
felsoszolnok - Felsőszölnök
felsotarkany - Felsőtárkány
felsotelekes - Felsőtelekes
felsotold - Felsőtold
felsovadasz - Felsővadász
felsozsolca - Felsőzsolca
fenyeslitke - Fényeslitke
fenyofo - Fenyőfő
ferencszallas - Ferencszállás
fertoboz - Fertőboz
fertod - Fertőd
fertoendred - Fertőendréd
fertohomok - Fertőhomok
fertorakos - Fertőrákos
fertoszentmiklos - Fertőszentmiklós
fertoszeplak - Fertőszéplak
fiad - Fiad
filkehaza - Filkeháza
fityehaz - Fityeház
fokto - Foktő
folyas - Folyás
fono - Fonó
fony - Fony
fonyod - Fonyód
forraskut - Forráskút
forro - Forró
fot - Fót
foldeak - Földeák
foldes - Földes
fonyed - Főnyed
fulokercs - Fulókércs
furta - Furta
fule - Füle
fulesd - Fülesd
fulop - Fülöp
fulophaza - Fülöpháza
fulopjakab - Fülöpjakab
fulopszallas - Fülöpszállás
fulposdaroc - Fülpösdaróc
furged - Fürged
fuzer - Füzér
fuzerkajata - Füzérkajata
fuzerkomlos - Füzérkomlós
fuzerradvany - Füzérradvány
fuzesabony - Füzesabony
fuzesgyarmat - Füzesgyarmat
fuzvolgy - Fűzvölgy
gaborjan - Gáborján
gaborjanhaza - Gáborjánháza
gacsaly - Gacsály
gadacs - Gadács
gadany - Gadány
gadna - Gadna
gadoros - Gádoros
gagyapati - Gagyapáti
gagybator - Gagybátor
gagyvendegi - Gagyvendégi
galambok - Galambok
galgaguta - Galgaguta
galgagyork - Galgagyörk
galgaheviz - Galgahévíz
galgamacsa - Galgamácsa
galosfa - Gálosfa
galvacs - Galvács
gamas - Gamás
ganna - Ganna
gant - Gánt
gara - Gara
garab - Garáb
garabonc - Garabonc
garadna - Garadna
garbolc - Garbolc
gardony - Gárdony
gare - Garé
gasztony - Gasztony
gater - Gátér
gavavencsello - Gávavencsellő
geberjen - Géberjén
gecse - Gecse
gederlak - Géderlak
gegeny - Gégény
gelej - Gelej
gelenes - Gelénes
gellenhaza - Gellénháza
gelse - Gelse
gelsesziget - Gelsesziget
gemzse - Gemzse
gencsapati - Gencsapáti
gerce - Gérce
gerde - Gerde
gerendas - Gerendás
gerenyes - Gerényes
geresdlak - Geresdlak
gerjen - Gerjen
gersekarat - Gersekarát
geszt - Geszt
gesztely - Gesztely
gesztered - Geszteréd
getye - Gétye
gibart - Gibárt
gic - Gic
gige - Gige
gilvanfa - Gilvánfa
girincs - Girincs
goganfa - Gógánfa
golop - Golop
gomba - Gomba
gombosszeg - Gombosszeg
gor - Gór
gordisa - Gordisa
gosztola - Gosztola
god - Göd
godollo - Gödöllő
godre - Gödre
golle - Gölle
gomorszolos - Gömörszőlős
gonc - Gönc
goncruszka - Göncruszka
gonyu - Gönyű
gorbehaza - Görbeháza
gorcsony - Görcsöny
gorcsonydoboka - Görcsönydoboka
gorgeteg - Görgeteg
gosfa - Gősfa
graboc - Grábóc
gulacs - Gulács
gutorfolde - Gutorfölde
gyal - Gyál
gyaloka - Gyalóka
gyanogeregye - Gyanógeregye
gyarmat - Gyarmat
gyekenyes - Gyékényes
gyenesdias - Gyenesdiás
gyepukajan - Gyepükaján
gyermely - Gyermely
gyod - Gyód
gyomaendrod - Gyomaendrőd
gyoro - Gyóró
gyomore - Gyömöre
gyomro - Gyömrő
gyongyfa - Gyöngyfa
gyongyos - Gyöngyös
gyongyosfalu - Gyöngyösfalu
gyongyoshalasz - Gyöngyöshalász
gyongyosmellek - Gyöngyösmellék
gyongyosoroszi - Gyöngyösoroszi
gyongyospata - Gyöngyöspata
gyongyossolymos - Gyöngyössolymos
gyongyostarjan - Gyöngyöstarján
gyonk - Gyönk
gyor - Győr
gyorasszonyfa - Győrasszonyfa
gyore - Györe
gyorgytarlo - Györgytarló
gyorkony - Györköny
gyorladamer - Győrladamér
gyorocske - Győröcske
gyorsag - Győrság
gyorsovenyhaz - Győrsövényház
gyorszemere - Győrszemere
gyortelek - Győrtelek
gyorujbarat - Győrújbarát
gyorujfalu - Győrújfalu
gyorvar - Győrvár
gyorzamoly - Győrzámoly
gyugy - Gyugy
gyula - Gyula
gyulahaza - Gyulaháza
gyulaj - Gyulaj
gyulakeszi - Gyulakeszi
gyuro - Gyúró
gyugye - Gyügye
gyure - Gyüre
gyurus - Gyűrűs
hacs - Hács
hagyarosborond - Hagyárosbörönd
hahot - Hahót
hajdubagos - Hajdúbagos
hajduboszormeny - Hajdúböszörmény
hajdudorog - Hajdúdorog
hajduhadhaz - Hajdúhadház
hajdunanas - Hajdúnánás
hajdusamson - Hajdúsámson
hajduszoboszlo - Hajdúszoboszló
hajduszovat - Hajdúszovát
hajmas - Hajmás
hajmasker - Hajmáskér
hajos - Hajós
halasto - Halastó
halaszi - Halászi
halasztelek - Halásztelek
halimba - Halimba
halmaj - Halmaj
halmajugra - Halmajugra
halogy - Halogy
hangacs - Hangács
hangony - Hangony
hantos - Hantos
harasztifalu - Harasztifalu
harc - Harc
harka - Harka
harkakotony - Harkakötöny
harkany - Harkány
haromfa - Háromfa
haromhuta - Háromhuta
harsany - Harsány
harskut - Hárskút
harta - Harta
hassagy - Hásságy
hatvan - Hatvan
hedervar - Hédervár
hedrehely - Hedrehely
hegyesd - Hegyesd
hegyeshalom - Hegyeshalom
hegyfalu - Hegyfalu
hegyhathodasz - Hegyháthodász
hegyhatmaroc - Hegyhátmaróc
hegyhatsal - Hegyhátsál
hegyhatszentjakab - Hegyhátszentjakab
hegyhatszentmarton - Hegyhátszentmárton
hegyhatszentpeter - Hegyhátszentpéter
hegyko - Hegykő
hegymagas - Hegymagas
hegymeg - Hegymeg
hegyszentmarton - Hegyszentmárton
hehalom - Héhalom
hejce - Hejce
hejobaba - Hejőbába
hejokeresztur - Hejőkeresztúr
hejokurt - Hejőkürt
hejopapi - Hejőpapi
hejoszalonta - Hejőszalonta
helesfa - Helesfa
helvecia - Helvécia
hencida - Hencida
hencse - Hencse
herceghalom - Herceghalom
hercegkut - Hercegkút
hercegszanto - Hercegszántó
hered - Heréd
hereg - Héreg
herencseny - Herencsény
herend - Herend
heresznye - Heresznye
hermanszeg - Hermánszeg
hernad - Hernád
hernadbud - Hernádbűd
hernadcece - Hernádcéce
hernadkak - Hernádkak
hernadkercs - Hernádkércs
hernadnemeti - Hernádnémeti
hernadpetri - Hernádpetri
hernadszentandras - Hernádszentandrás
hernadszurdok - Hernádszurdok
hernadvecse - Hernádvécse
hernyek - Hernyék
het - Hét
hetefejercse - Hetefejércse
hetes - Hetes
hetvehely - Hetvehely
hetyefo - Hetyefő
heves - Heves
hevesaranyos - Hevesaranyos
hevesvezekeny - Hevesvezekény
heviz - Hévíz
hevizgyork - Hévízgyörk
hidas - Hidas
hidasnemeti - Hidasnémeti
hidegkut - Hidegkút
hidegseg - Hidegség
hidvegardo - Hidvégardó
himeshaza - Himesháza
himod - Himod
hirics - Hirics
hobol - Hobol
hodasz - Hodász
hodmezovasarhely - Hódmezővásárhely
hollad - Hollád
hollohaza - Hollóháza
holloko - Hollókő
homokbodoge - Homokbödöge
homokkomarom - Homokkomárom
homokmegy - Homokmégy
homokszentgyorgy - Homokszentgyörgy
homorud - Homorúd
homrogd - Homrogd
hont - Hont
horpacs - Horpács
hort - Hort
hortobagy - Hortobágy
horvathertelend - Horváthertelend
horvatlovo - Horvátlövő
horvatzsidany - Horvátzsidány
hosszuheteny - Hosszúhetény
hosszupalyi - Hosszúpályi
hosszupereszteg - Hosszúpereszteg
hosszuviz - Hosszúvíz
hosszuvolgy - Hosszúvölgy
hosztot - Hosztót
hotto - Hottó
hogyesz - Hőgyész
hovej - Hövej
hugyag - Hugyag
hunya - Hunya
hunyadfalva - Hunyadfalva
husztot - Husztót
ibafa - Ibafa
iborfia - Iborfia
ibrany - Ibrány
igal - Igal
igar - Igar
igrici - Igrici
iharos - Iharos
iharosbereny - Iharosberény
ikervar - Ikervár
iklad - Iklad
iklanbereny - Iklanberény
iklodbordoce - Iklódbördőce
ikreny - Ikrény
iliny - Iliny
ilk - Ilk
illocska - Illocska
imola - Imola
imrehegy - Imrehegy
inancs - Ináncs
inarcs - Inárcs
inke - Inke
ipacsfa - Ipacsfa
ipolydamasd - Ipolydamásd
ipolyszog - Ipolyszög
ipolytarnoc - Ipolytarnóc
ipolytolgyes - Ipolytölgyes
ipolyvece - Ipolyvece
iregszemcse - Iregszemcse
irota - Irota
isaszeg - Isaszeg
ispank - Ispánk
istenmezeje - Istenmezeje
istvandi - Istvándi
iszkaszentgyorgy - Iszkaszentgyörgy
iszkaz - Iszkáz
isztimer - Isztimér
ivad - Ivád
ivan - Iván
ivanbattyan - Ivánbattyán
ivanc - Ivánc
ivancsa - Iváncsa
ivandarda - Ivándárda
izmeny - Izmény
izsak - Izsák
izsofalva - Izsófalva
jagonak - Jágónak
jak - Ják
jakabszallas - Jakabszállás
jakfa - Jákfa
jakfalva - Jákfalva
jako - Jákó
jand - Jánd
jankmajtis - Jánkmajtis
janoshalma - Jánoshalma
janoshaza - Jánosháza
janoshida - Jánoshida
janossomorja - Jánossomorja
jardanhaza - Járdánháza
jarmi - Jármi
jasd - Jásd
jaszago - Jászágó
jaszalsoszentgyorgy - Jászalsószentgyörgy
jaszapati - Jászapáti
jaszarokszallas - Jászárokszállás
jaszbereny - Jászberény
jaszboldoghaza - Jászboldogháza
jaszdozsa - Jászdózsa
jaszfelsoszentgyorgy - Jászfelsőszentgyörgy
jaszfenyszaru - Jászfényszaru
jaszivany - Jászivány
jaszjakohalma - Jászjákóhalma
jaszkarajeno - Jászkarajenő
jaszkiser - Jászkisér
jaszladany - Jászladány
jaszszentandras - Jászszentandrás
jaszszentlaszlo - Jászszentlászló
jasztelek - Jásztelek
jeke - Jéke
jeno - Jenő
jobahaza - Jobaháza
jobbagyi - Jobbágyi
josvafo - Jósvafő
juta - Juta
kaba - Kaba
kacorlak - Kacorlak
kacs - Kács
kacsota - Kacsóta
kadarkut - Kadarkút
kajarpec - Kajárpéc
kajaszo - Kajászó
kajdacs - Kajdacs
kakasd - Kakasd
kakics - Kákics
kakucs - Kakucs
kal - Kál
kalazno - Kalaznó
kald - Káld
kallo - Kálló
kallosd - Kallósd
kallosemjen - Kállósemjén
kalmancsa - Kálmáncsa
kalmanhaza - Kálmánháza
kalocfa - Kálócfa
kalocsa - Kalocsa
kaloz - Káloz
kam - Kám
kamond - Kamond
kamut - Kamut
kano - Kánó
kantorjanosi - Kántorjánosi
kany - Kány
kanya - Kánya
kanyavar - Kányavár
kapolcs - Kapolcs
kapolna - Kápolna
kapolnasnyek - Kápolnásnyék
kapoly - Kapoly
kaposfo - Kaposfő
kaposgyarmat - Kaposgyarmat
kaposhomok - Kaposhomok
kaposkeresztur - Kaposkeresztúr
kaposmero - Kaposmérő
kapospula - Kapospula
kaposujlak - Kaposújlak
kaposvar - Kaposvár
kaposszekcso - Kaposszekcső
kaposszerdahely - Kaposszerdahely
kaptalanfa - Káptalanfa
kaptalantoti - Káptalantóti
kapuvar - Kapuvár
kara - Kára
karacsond - Karácsond
karad - Karád
karako - Karakó
karakoszorcsok - Karakószörcsök
karancsalja - Karancsalja
karancsbereny - Karancsberény
karancskeszi - Karancskeszi
karancslapujto - Karancslapujtő
karancssag - Karancsság
karasz - Kárász
karcag - Karcag
karcsa - Karcsa
kardos - Kardos
kardoskut - Kardoskút
karmacs - Karmacs
karolyhaza - Károlyháza
karos - Karos
kartal - Kartal
kasad - Kásád
kaskantyu - Kaskantyú
kastelyosdombo - Kastélyosdombó
kaszaper - Kaszaper
kaszo - Kaszó
katadfa - Katádfa
katafa - Katafa
katoly - Kátoly
katymar - Katymár
kava - Káva
kavas - Kávás
kazar - Kazár
kazincbarcika - Kazincbarcika
kazsmark - Kázsmárk
kazsok - Kazsok
kecel - Kecel
kecsked - Kecskéd
kecskemet - Kecskemét
kehidakustany - Kehidakustány
kek - Kék
kekcse - Kékcse
keked - Kéked
kekesd - Kékesd
kekkut - Kékkút
kelebia - Kelebia
keled - Keléd
kelemer - Kelemér
keleshalom - Kéleshalom
keleviz - Kelevíz
kemecse - Kemecse
kemence - Kemence
kemendollar - Kemendollár
kemeneshogyesz - Kemeneshőgyész
kemeneskapolna - Kemeneskápolna
kemenesmagasi - Kemenesmagasi
kemenesmihalyfa - Kemenesmihályfa
kemenespalfa - Kemenespálfa
kemenessomjen - Kemenessömjén
kemenesszentmarton - Kemenesszentmárton
kemenesszentpeter - Kemenesszentpéter
kemenfa - Keménfa
kemes - Kémes
kemestarodfa - Kemestaródfa
kemse - Kemse
kenderes - Kenderes
kenez - Kenéz
kenezlo - Kenézlő
kengyel - Kengyel
kenyeri - Kenyeri
kercaszomor - Kercaszomor
kercseliget - Kercseliget
kerecsend - Kerecsend
kerecseny - Kerecseny
kerekegyhaza - Kerekegyháza
kerekharaszt - Kerekharaszt
kereki - Kereki
kerekteleki - Kerékteleki
kerepes - Kerepes
keresztete - Keresztéte
kerkabarabas - Kerkabarabás
kerkafalva - Kerkafalva
kerkakutas - Kerkakutas
kerkaskapolna - Kerkáskápolna
kerkaszentkiraly - Kerkaszentkirály
kerkateskand - Kerkateskánd
kersemjen - Kérsemjén
kerta - Kerta
kerteszsziget - Kertészsziget
keszeg - Keszeg
kesznyeten - Kesznyéten
keszohidegkut - Keszőhidegkút
keszthely - Keszthely
kesztolc - Kesztölc
keszu - Keszü
ketbodony - Kétbodony
ketegyhaza - Kétegyháza
kethely - Kéthely
ketpo - Kétpó
ketsoprony - Kétsoprony
ketujfalu - Kétújfalu
ketvolgy - Kétvölgy
kety - Kéty
kevermes - Kevermes
kiliman - Kilimán
kimle - Kimle
kincsesbanya - Kincsesbánya
kirald - Királd
kiralyegyhaza - Királyegyháza
kiralyhegyes - Királyhegyes
kiralyszentistvan - Királyszentistván
kisapati - Kisapáti
kisapostag - Kisapostag
kisar - Kisar
kisasszond - Kisasszond
kisasszonyfa - Kisasszonyfa
kisbabot - Kisbabot
kisbagyon - Kisbágyon
kisbajcs - Kisbajcs
kisbajom - Kisbajom
kisbarapati - Kisbárapáti
kisbarkany - Kisbárkány
kisber - Kisbér
kisbereny - Kisberény
kisberzseny - Kisberzseny
kisbeszterce - Kisbeszterce
kisbodak - Kisbodak
kisbucsa - Kisbucsa
kisbudmer - Kisbudmér
kiscsecs - Kiscsécs
kiscsehi - Kiscsehi
kiscsosz - Kiscsősz
kisder - Kisdér
kisdobsza - Kisdobsza
kisdombegyhaz - Kisdombegyház
kisdorog - Kisdorog
kisecset - Kisecset
kisfalud - Kisfalud
kisfuzes - Kisfüzes
kisgorbo - Kisgörbő
kisgyalan - Kisgyalán
kisgyor - Kisgyőr
kishajmas - Kishajmás
kisharsany - Kisharsány
kishartyan - Kishartyán
kisherend - Kisherend
kishodos - Kishódos
kishuta - Kishuta
kisigmand - Kisigmánd
kisjakabfalva - Kisjakabfalva
kiskassa - Kiskassa
kiskinizs - Kiskinizs
kiskorpad - Kiskorpád
kiskore - Kisköre
kiskoros - Kiskőrös
kiskunfelegyhaza - Kiskunfélegyháza
kiskunhalas - Kiskunhalas
kiskunlachaza - Kiskunlacháza
kiskunmajsa - Kiskunmajsa
kiskutas - Kiskutas
kislang - Kisláng
kisleta - Kisléta
kislippo - Kislippó
kislod - Kislőd
kismanyok - Kismányok
kismarja - Kismarja
kismaros - Kismaros
kisnameny - Kisnamény
kisnana - Kisnána
kisnemedi - Kisnémedi
kisnyarad - Kisnyárád
kisoroszi - Kisoroszi
kispalad - Kispalád
kispali - Kispáli
kispirit - Kispirit
kisrakos - Kisrákos
kisrecse - Kisrécse
kisrozvagy - Kisrozvágy
kissikator - Kissikátor
kissomlyo - Kissomlyó
kistamasi - Kistamási
kistapolca - Kistapolca
kistarcsa - Kistarcsa
kistelek - Kistelek
kistokaj - Kistokaj
kistolmacs - Kistolmács
kistormas - Kistormás
kistotfalu - Kistótfalu
kisujszallas - Kisújszállás
kisunyom - Kisunyom
kisvarda - Kisvárda
kisvarsany - Kisvarsány
kisvasarhely - Kisvásárhely
kisvaszar - Kisvaszar
kisvejke - Kisvejke
kiszombor - Kiszombor
kiszsidany - Kiszsidány
kisszallas - Kisszállás
kisszekely - Kisszékely
kisszekeres - Kisszekeres
kisszentmarton - Kisszentmárton
kissziget - Kissziget
kisszolos - Kisszőlős
klarafalva - Klárafalva
kocs - Kocs
kocser - Kocsér
kocsola - Kocsola
kocsord - Kocsord
koka - Kóka
kokad - Kokad
kolontar - Kolontár
komadi - Komádi
komarom - Komárom
komjati - Komjáti
komlo - Komló
komlodtotfalu - Komlódtótfalu
komlosd - Komlósd
komloska - Komlóska
komoro - Komoró
kompolt - Kompolt
kondo - Kondó
kondorfa - Kondorfa
kondoros - Kondoros
kony - Kóny
konyar - Konyár
kophaza - Kópháza
koppanyszanto - Koppányszántó
korlat - Korlát
koronco - Koroncó
koros - Kórós
kosd - Kosd
kospallag - Kóspallag
kotaj - Kótaj
kovacshida - Kovácshida
kovacsszenaja - Kovácsszénája
kovacsvagas - Kovácsvágás
kozard - Kozárd
kozarmisleny - Kozármisleny
kozmadombja - Kozmadombja
kobleny - Köblény
kocsk - Köcsk
kokeny - Kökény
kokut - Kőkút
kolcse - Kölcse
kolesd - Kölesd
kolked - Kölked
komlo - Kömlő
komlod - Kömlőd
komoro - Kömörő
kompoc - Kömpöc
kormend - Körmend
kornye - Környe
korom - Köröm
koroshegy - Kőröshegy
korosladany - Körösladány
korosnagyharsany - Körösnagyharsány
korostarcsa - Köröstarcsa
korostetetlen - Kőröstetétlen
korosujfalu - Körösújfalu
korosszakal - Körösszakál
korosszegapati - Körösszegapáti
koszarhegy - Kőszárhegy
koszeg - Kőszeg
koszegdoroszlo - Kőszegdoroszló
koszegpaty - Kőszegpaty
koszegszerdahely - Kőszegszerdahely
kotcse - Kötcse
kotegyan - Kötegyán
kotelek - Kőtelek
kovagoors - Kővágóörs
kovagoszolos - Kővágószőlős
kovagotottos - Kővágótöttös
kovegy - Kövegy
koveskal - Köveskál
krasznokvajda - Krasznokvajda
kulcs - Kulcs
kunadacs - Kunadacs
kunagota - Kunágota
kunbaja - Kunbaja
kunbaracs - Kunbaracs
kuncsorba - Kuncsorba
kunfeherto - Kunfehértó
kunhegyes - Kunhegyes
kunmadaras - Kunmadaras
kunpeszer - Kunpeszér
kunszallas - Kunszállás
kunszentmarton - Kunszentmárton
kunszentmiklos - Kunszentmiklós
kunsziget - Kunsziget
kup - Kup
kupa - Kupa
kurd - Kurd
kurityan - Kurityán
kustanszeg - Kustánszeg
kutas - Kutas
kutaso - Kutasó
kubekhaza - Kübekháza
kulsosard - Külsősárd
kulsovat - Külsővat
kungos - Küngös
labatlan - Lábatlan
labod - Lábod
lacacseke - Lácacséke
lad - Lad
ladanybene - Ladánybene
ladbesenyo - Ládbesenyő
lajoskomarom - Lajoskomárom
lajosmizse - Lajosmizse
lak - Lak
lakhegy - Lakhegy
lakitelek - Lakitelek
lakocsa - Lakócsa
lanycsok - Lánycsók
lapafo - Lápafő
lapancsa - Lapáncsa
laskod - Laskod
lasztonya - Lasztonya
latrany - Látrány
lazi - Lázi
leanyfalu - Leányfalu
leanyvar - Leányvár
lebeny - Lébény
legend - Legénd
legyesbenye - Legyesbénye
leh - Léh
lenarddaroc - Lénárddaróc
lendvadedes - Lendvadedes
lendvajakabfa - Lendvajakabfa
lengyel - Lengyel
lengyeltoti - Lengyeltóti
lenti - Lenti
lepseny - Lepsény
lesencefalu - Lesencefalu
lesenceistvand - Lesenceistvánd
lesencetomaj - Lesencetomaj
letavertes - Létavértes
letenye - Letenye
letkes - Letkés
level - Levél
levelek - Levelek
libickozma - Libickozma
lickovadamos - Lickóvadamos
liget - Liget
ligetfalva - Ligetfalva
lipot - Lipót
lippo - Lippó
liptod - Liptód
lispeszentadorjan - Lispeszentadorján
liszo - Liszó
liter - Litér
litka - Litka
litke - Litke
locs - Lócs
lokut - Lókút
lonya - Lónya
lorev - Lórév
lothard - Lothárd
lovas - Lovas
lovasbereny - Lovasberény
lovaszheteny - Lovászhetény
lovaszi - Lovászi
lovaszpatona - Lovászpatona
lokoshaza - Lőkösháza
lorinci - Lőrinci
lovo - Lövő
lovopetri - Lövőpetri
lucfalva - Lucfalva
ludanyhalaszi - Ludányhalászi
ludas - Ludas
lukacshaza - Lukácsháza
lulla - Lulla
luzsok - Lúzsok
mad - Mád
madaras - Madaras
madocsa - Madocsa
magloca - Maglóca
maglod - Maglód
magocs - Mágocs
magosliget - Magosliget
magy - Magy
magyaralmas - Magyaralmás
magyaratad - Magyaratád
magyarbanhegyes - Magyarbánhegyes
magyarboly - Magyarbóly
magyarcsanad - Magyarcsanád
magyardombegyhaz - Magyardombegyház
magyaregregy - Magyaregregy
magyaregres - Magyaregres
magyarfold - Magyarföld
magyargec - Magyargéc
magyargencs - Magyargencs
magyarhertelend - Magyarhertelend
magyarhomorog - Magyarhomorog
magyarkeresztur - Magyarkeresztúr
magyarkeszi - Magyarkeszi
magyarlak - Magyarlak
magyarlukafa - Magyarlukafa
magyarmecske - Magyarmecske
magyarnadalja - Magyarnádalja
magyarnandor - Magyarnándor
magyarpolany - Magyarpolány
magyarsarlos - Magyarsarlós
magyarszecsod - Magyarszecsőd
magyarszek - Magyarszék
magyarszentmiklos - Magyarszentmiklós
magyarszerdahely - Magyarszerdahely
magyarszombatfa - Magyarszombatfa
magyartelek - Magyartelek
majoshaza - Majosháza
majs - Majs
makad - Makád
makkoshotyka - Makkoshotyka
maklar - Maklár
mako - Makó
malomsok - Malomsok
malyi - Mályi
malyinka - Mályinka
mand - Mánd
mandok - Mándok
manfa - Mánfa
many - Mány
maraza - Maráza
marcalgergelyi - Marcalgergelyi
marcali - Marcali
marcalto - Marcaltő
marfa - Márfa
mariahalom - Máriahalom
mariakalnok - Máriakálnok
mariakemend - Máriakéménd
marianosztra - Márianosztra
mariapocs - Máriapócs
markaz - Markaz
markhaza - Márkháza
marko - Márkó
markoc - Markóc
markotabodoge - Markotabödöge
maroc - Maróc
marocsa - Marócsa
marok - Márok
marokfold - Márokföld
marokpapi - Márokpapi
maroslele - Maroslele
martely - Mártély
martfu - Martfű
martonfa - Martonfa
martonvasar - Martonvásár
martonyi - Martonyi
mateszalka - Mátészalka
matetelke - Mátételke
matraballa - Mátraballa
matraderecske - Mátraderecske
matramindszent - Mátramindszent
matranovak - Mátranovák
matraszele - Mátraszele
matraszentimre - Mátraszentimre
matraszolos - Mátraszőlős
matraterenye - Mátraterenye
matraverebely - Mátraverebély
matyasdomb - Mátyásdomb
matty - Matty
matyus - Mátyus
maza - Máza
mecseknadasd - Mecseknádasd
mecsekpoloske - Mecsekpölöske
mecser - Mecsér
medgyesbodzas - Medgyesbodzás
medgyesegyhaza - Medgyesegyháza
medina - Medina
megyaszo - Megyaszó
megyehid - Megyehíd
megyer - Megyer
meggyeskovacsi - Meggyeskovácsi
mehkerek - Méhkerék
mehtelek - Méhtelek
mekenyes - Mekényes
melykut - Mélykút
mencshely - Mencshely
mende - Mende
mera - Méra
merenye - Merenye
merges - Mérges
merk - Mérk
mernye - Mernye
mersevat - Mersevát
mesterhaza - Mesterháza
mesteri - Mesteri
mesterszallas - Mesterszállás
meszes - Meszes
meszlen - Meszlen
mesztegnyo - Mesztegnyő
mezobereny - Mezőberény
mezocsat - Mezőcsát
mezocsokonya - Mezőcsokonya
mezod - Meződ
mezofalva - Mezőfalva
mezogyan - Mezőgyán
mezohegyes - Mezőhegyes
mezohek - Mezőhék
mezokeresztes - Mezőkeresztes
mezokomarom - Mezőkomárom
mezokovacshaza - Mezőkovácsháza
mezokovesd - Mezőkövesd
mezoladany - Mezőladány
mezolak - Mezőlak
mezonagymihaly - Mezőnagymihály
mezonyarad - Mezőnyárád
mezoors - Mezőörs
mezopeterd - Mezőpeterd
mezosas - Mezősas
mezoszemere - Mezőszemere
mezoszentgyorgy - Mezőszentgyörgy
mezoszilas - Mezőszilas
mezotarkany - Mezőtárkány
mezotur - Mezőtúr
mezozombor - Mezőzombor
mihald - Miháld
mihalyfa - Mihályfa
mihalygerge - Mihálygerge
mihalyhaza - Mihályháza
mihalyi - Mihályi
mike - Mike
mikebuda - Mikebuda
mikekaracsonyfa - Mikekarácsonyfa
mikepercs - Mikepércs
miklosi - Miklósi
mikofalva - Mikófalva
mikohaza - Mikóháza
mikosszeplak - Mikosszéplak
milejszeg - Milejszeg
milota - Milota
mindszent - Mindszent
mindszentgodisa - Mindszentgodisa
mindszentkalla - Mindszentkálla
misefa - Misefa
miske - Miske
miskolc - Miskolc
miszla - Miszla
mocsa - Mocsa
mogyorod - Mogyoród
mogyorosbanya - Mogyorósbánya
mogyoroska - Mogyoróska
moha - Moha
mohacs - Mohács
mohora - Mohora
molnari - Molnári
molnaszecsod - Molnaszecsőd
molvany - Molvány
monaj - Monaj
monok - Monok
monor - Monor
monorierdo - Monorierdő
monosbel - Mónosbél
monostorapati - Monostorapáti
monostorpalyi - Monostorpályi
monoszlo - Monoszló
monyorod - Monyoród
mor - Mór
moragy - Mórágy
morahalom - Mórahalom
moricgat - Móricgát
morichida - Mórichida
mosdos - Mosdós
mosonmagyarovar - Mosonmagyaróvár
mosonszentmiklos - Mosonszentmiklós
mosonszolnok - Mosonszolnok
mosonudvar - Mosonudvar
mozsgo - Mozsgó
mocseny - Mőcsény
mucsfa - Mucsfa
mucsi - Mucsi
mucsony - Múcsony
muhi - Muhi
murakeresztur - Murakeresztúr
muraratka - Murarátka
muraszemenye - Muraszemenye
murga - Murga
murony - Murony
nabrad - Nábrád
nadap - Nadap
nadasd - Nádasd
nadasdladany - Nádasdladány
nadudvar - Nádudvar
nagocs - Nágocs
nagyacsad - Nagyacsád
nagyalasony - Nagyalásony
nagyar - Nagyar
nagyatad - Nagyatád
nagybajcs - Nagybajcs
nagybajom - Nagybajom
nagybakonak - Nagybakónak
nagybanhegyes - Nagybánhegyes
nagybaracska - Nagybaracska
nagybarca - Nagybarca
nagybarkany - Nagybárkány
nagybereny - Nagyberény
nagyberki - Nagyberki
nagyborzsony - Nagybörzsöny
nagybudmer - Nagybudmér
nagycenk - Nagycenk
nagycsany - Nagycsány
nagycsecs - Nagycsécs
nagycsepely - Nagycsepely
nagycserkesz - Nagycserkesz
nagydem - Nagydém
nagydobos - Nagydobos
nagydobsza - Nagydobsza
nagydorog - Nagydorog
nagyecsed - Nagyecsed
nagyer - Nagyér
nagyesztergar - Nagyesztergár
nagyfuged - Nagyfüged
nagygeresd - Nagygeresd
nagygorbo - Nagygörbő
nagygyimot - Nagygyimót
nagyhajmas - Nagyhajmás
nagyhalasz - Nagyhalász
nagyharsany - Nagyharsány
nagyhegyes - Nagyhegyes
nagyhodos - Nagyhódos
nagyhuta - Nagyhuta
nagyigmand - Nagyigmánd
nagyivan - Nagyiván
nagykallo - Nagykálló
nagykamaras - Nagykamarás
nagykanizsa - Nagykanizsa
nagykapornak - Nagykapornak
nagykaracsony - Nagykarácsony
nagykata - Nagykáta
nagykereki - Nagykereki
nagykeresztur - Nagykeresztúr
nagykinizs - Nagykinizs
nagykonyi - Nagykónyi
nagykorpad - Nagykorpád
nagykovacsi - Nagykovácsi
nagykozar - Nagykozár
nagykokenyes - Nagykökényes
nagykolked - Nagykölked
nagykoros - Nagykőrös
nagykoru - Nagykörű
nagykutas - Nagykutas
nagylak - Nagylak
nagylengyel - Nagylengyel
nagyloc - Nagylóc
nagylok - Nagylók
nagylozs - Nagylózs
nagymagocs - Nagymágocs
nagymanyok - Nagymányok
nagymaros - Nagymaros
nagymizdo - Nagymizdó
nagynyarad - Nagynyárád
nagyoroszi - Nagyoroszi
nagypali - Nagypáli
nagypall - Nagypall
nagypeterd - Nagypeterd
nagypirit - Nagypirit
nagyrabe - Nagyrábé
nagyrada - Nagyrada
nagyrakos - Nagyrákos
nagyrecse - Nagyrécse
nagyrede - Nagyréde
nagyrev - Nagyrév
nagyrozvagy - Nagyrozvágy
nagysap - Nagysáp
nagysimonyi - Nagysimonyi
nagyszakacsi - Nagyszakácsi
nagyszekely - Nagyszékely
nagyszekeres - Nagyszekeres
nagyszenas - Nagyszénás
nagyszentjanos - Nagyszentjános
nagyszokoly - Nagyszokoly
nagytalya - Nagytálya
nagytarcsa - Nagytarcsa
nagytevel - Nagytevel
nagytilaj - Nagytilaj
nagytotfalu - Nagytótfalu
nagytoke - Nagytőke
nagyut - Nagyút
nagyvarsany - Nagyvarsány
nagyvaty - Nagyváty
nagyvazsony - Nagyvázsony
nagyvejke - Nagyvejke
nagyveleg - Nagyveleg
nagyvenyim - Nagyvenyim
nagyvisnyo - Nagyvisnyó
nak - Nak
napkor - Napkor
narai - Nárai
narda - Narda
naszaly - Naszály
negyes - Négyes
nekezseny - Nekézseny
nemesapati - Nemesapáti
nemesbikk - Nemesbikk
nemesborzova - Nemesborzova
nemesbod - Nemesbőd
nemesbuk - Nemesbük
nemescso - Nemescsó
nemesded - Nemesdéd
nemesgorzsony - Nemesgörzsöny
nemesgulacs - Nemesgulács
nemeshany - Nemeshany
nemeshetes - Nemeshetés
nemeske - Nemeske
nemesker - Nemeskér
nemeskeresztur - Nemeskeresztúr
nemeskisfalud - Nemeskisfalud
nemeskocs - Nemeskocs
nemeskolta - Nemeskolta
nemesladony - Nemesládony
nemesmedves - Nemesmedves
nemesnadudvar - Nemesnádudvar
nemesnep - Nemesnép
nemespatro - Nemespátró
nemesrado - Nemesrádó
nemesrempehollos - Nemesrempehollós
nemessandorhaza - Nemessándorháza
nemesvamos - Nemesvámos
nemesvid - Nemesvid
nemesvita - Nemesvita
nemesszalok - Nemesszalók
nemesszentandras - Nemesszentandrás
nemetbanya - Németbánya
nemetfalu - Németfalu
nemetker - Németkér
nemti - Nemti
neszmely - Neszmély
nezsa - Nézsa
nick - Nick
nikla - Nikla
nograd - Nógrád
nogradkovesd - Nógrádkövesd
nogradmarcal - Nógrádmarcal
nogradmegyer - Nógrádmegyer
nogradsap - Nógrádsáp
nogradsipek - Nógrádsipek
nogradszakal - Nógrádszakál
norap - Nóráp
noszlop - Noszlop
noszvaj - Noszvaj
nova - Nova
novaj - Novaj
novajidrany - Novajidrány
notincs - Nőtincs
nyalka - Nyalka
nyarad - Nyárád
nyaregyhaza - Nyáregyháza
nyarlorinc - Nyárlőrinc
nyarsapat - Nyársapát
nyekladhaza - Nyékládháza
nyergesujfalu - Nyergesújfalu
nyesta - Nyésta
nyim - Nyim
nyirabrany - Nyírábrány
nyiracsad - Nyíracsád
nyirad - Nyirád
nyiradony - Nyíradony
nyirbator - Nyírbátor
nyirbeltek - Nyírbéltek
nyirbogat - Nyírbogát
nyirbogdany - Nyírbogdány
nyircsaholy - Nyírcsaholy
nyircsaszari - Nyírcsászári
nyirderzs - Nyírderzs
nyiregyhaza - Nyíregyháza
nyirgelse - Nyírgelse
nyirgyulaj - Nyírgyulaj
nyiri - Nyíri
nyiribrony - Nyíribrony
nyirjako - Nyírjákó
nyirkarasz - Nyírkarász
nyirkata - Nyírkáta
nyirkercs - Nyírkércs
nyirlovo - Nyírlövő
nyirlugos - Nyírlugos
nyirmada - Nyírmada
nyirmartonfalva - Nyírmártonfalva
nyirmeggyes - Nyírmeggyes
nyirmihalydi - Nyírmihálydi
nyirparasznya - Nyírparasznya
nyirpazony - Nyírpazony
nyirpilis - Nyírpilis
nyirtass - Nyírtass
nyirtelek - Nyírtelek
nyirtet - Nyírtét
nyirtura - Nyírtura
nyirvasvari - Nyírvasvári
nyomar - Nyomár
nyoger - Nyőgér
nyugotszenterzsebet - Nyugotszenterzsébet
nyul - Nyúl
obanya - Óbánya
obarok - Óbarok
obudavar - Óbudavár
ocsa - Ócsa
ocsard - Ócsárd
ofalu - Ófalu
ofeherto - Ófehértó
ofoldeak - Óföldeák
ohid - Óhíd
okany - Okány
okorag - Okorág
okorvolgy - Okorvölgy
olasz - Olasz
olaszfa - Olaszfa
olaszfalu - Olaszfalu
olaszliszka - Olaszliszka
olcsva - Olcsva
olcsvaapati - Olcsvaapáti
old - Old
olmod - Ólmod
oltarc - Oltárc
onga - Onga
onod - Ónod
opalyi - Ópályi
opusztaszer - Ópusztaszer
orbanyosfa - Orbányosfa
orci - Orci
ordacsehi - Ordacsehi
ordas - Ordas
orfalu - Orfalu
orfu - Orfű
orgovany - Orgovány
ormandlak - Ormándlak
ormosbanya - Ormosbánya
oroshaza - Orosháza
oroszi - Oroszi
oroszlany - Oroszlány
oroszlo - Oroszló
orosztony - Orosztony
ortahaza - Ortaháza
osli - Osli
ostffyasszonyfa - Ostffyasszonyfa
ostoros - Ostoros
oszko - Oszkó
oszlar - Oszlár
osztopan - Osztopán
ozd - Ózd
ozdfalu - Ózdfalu
ozmanbuk - Ozmánbük
ozora - Ozora
ocs - Öcs
ocseny - Őcsény
ocsod - Öcsöd
okoritofulpos - Ököritófülpös
olbo - Ölbő
omboly - Ömböly
or - Őr
orbottyan - Őrbottyán
oregcserto - Öregcsertő
oreglak - Öreglak
orhalom - Őrhalom
orimagyarosd - Őrimagyarósd
oriszentpeter - Őriszentpéter
orkeny - Örkény
ormenyes - Örményes
ormenykut - Örménykút
ortilos - Őrtilos
orvenyes - Örvényes
osagard - Ősagárd
osi - Ősi
osku - Öskü
otteveny - Öttevény
ottomos - Öttömös
otvoskonyi - Ötvöskónyi
pacin - Pácin
pacsa - Pacsa
pacsony - Pácsony
padar - Padár
pahi - Páhi
paka - Páka
pakod - Pakod
pakozd - Pákozd
paks - Paks
pale - Palé
palfa - Pálfa
palfiszeg - Pálfiszeg
palhaza - Pálháza
pali - Páli
palkonya - Palkonya
palmajor - Pálmajor
palmonostora - Pálmonostora
palosvorosmart - Pálosvörösmart
palotabozsok - Palotabozsok
palotas - Palotás
paloznak - Paloznak
pamleny - Pamlény
pamuk - Pamuk
pand - Pánd
pankasz - Pankasz
pannonhalma - Pannonhalma
panyok - Pányok
panyola - Panyola
pap - Pap
papa - Pápa
papadereske - Pápadereske
papakovacsi - Pápakovácsi
papasalamon - Pápasalamon
papateszer - Pápateszér
papkeszi - Papkeszi
papoc - Pápoc
papos - Papos
paprad - Páprád
parad - Parád
paradsasvar - Parádsasvár
parasznya - Parasznya
pari - Pári
paszab - Paszab
paszto - Pásztó
pasztori - Pásztori
pat - Pat
patak - Patak
patalom - Patalom
patapoklosi - Patapoklosi
patca - Patca
patka - Pátka
patosfa - Patosfa
patroha - Pátroha
patvarc - Patvarc
paty - Páty
patyod - Pátyod
pazmand - Pázmánd
pazmandfalu - Pázmándfalu
pecel - Pécel
pecol - Pecöl
pecs - Pécs
pecsbagota - Pécsbagota
pecsdevecser - Pécsdevecser
pecsely - Pécsely
pecsudvard - Pécsudvard
pecsvarad - Pécsvárad
pellerd - Pellérd
pely - Pély
penc - Penc
peneszlek - Penészlek
penzesgyor - Pénzesgyőr
penyige - Penyige
per - Pér
perbal - Perbál
pere - Pere
perecse - Perecse
pereked - Pereked
perenye - Perenye
peresznye - Peresznye
pereszteg - Pereszteg
perkata - Perkáta
perkupa - Perkupa
perocseny - Perőcsény
peterd - Peterd
peterhida - Péterhida
peteri - Péteri
petervasara - Pétervására
petfurdo - Pétfürdő
pethohenye - Pethőhenye
petnehaza - Petneháza
petofibanya - Petőfibánya
petofiszallas - Petőfiszállás
petohaza - Petőháza
petomihalyfa - Petőmihályfa
petrikeresztur - Petrikeresztúr
petrivente - Petrivente
pettend - Pettend
piliny - Piliny
pilis - Pilis
pilisborosjeno - Pilisborosjenő
piliscsaba - Piliscsaba
piliscsev - Piliscsév
pilisjaszfalu - Pilisjászfalu
pilismarot - Pilismarót
pilisvorosvar - Pilisvörösvár
pilisszanto - Pilisszántó
pilisszentivan - Pilisszentiván
pilisszentkereszt - Pilisszentkereszt
pilisszentlaszlo - Pilisszentlászló
pincehely - Pincehely
pinkamindszent - Pinkamindszent
pinnye - Pinnye
piricse - Piricse
pirto - Pirtó
pisko - Piskó
pitvaros - Pitvaros
pocsa - Pócsa
pocsaj - Pocsaj
pocsmegyer - Pócsmegyer
pocspetri - Pócspetri
pogany - Pogány
poganyszentpeter - Pogányszentpéter
pokaszepetk - Pókaszepetk
polany - Polány
polgar - Polgár
polgardi - Polgárdi
pomaz - Pomáz
porcsalma - Porcsalma
pornoapati - Pornóapáti
poroszlo - Poroszló
porpac - Porpác
porrog - Porrog
porrogszentkiraly - Porrogszentkirály
porrogszentpal - Porrogszentpál
porszombat - Pórszombat
porva - Porva
posfa - Pósfa
potony - Potony
potyond - Potyond
poloske - Pölöske
poloskefo - Pölöskefő
porboly - Pörböly
pordefolde - Pördefölde
potrete - Pötréte
prugy - Prügy
pula - Pula
pusztaapati - Pusztaapáti
pusztaberki - Pusztaberki
pusztacsalad - Pusztacsalád
pusztacso - Pusztacsó
pusztadobos - Pusztadobos
pusztaederics - Pusztaederics
pusztafalu - Pusztafalu
pusztafoldvar - Pusztaföldvár
pusztahencse - Pusztahencse
pusztakovacsi - Pusztakovácsi
pusztamagyarod - Pusztamagyaród
pusztamerges - Pusztamérges
pusztamiske - Pusztamiske
pusztamonostor - Pusztamonostor
pusztaottlaka - Pusztaottlaka
pusztaradvany - Pusztaradvány
pusztaszabolcs - Pusztaszabolcs
pusztaszemes - Pusztaszemes
pusztaszentlaszlo - Pusztaszentlászló
pusztaszer - Pusztaszer
pusztavacs - Pusztavacs
pusztavam - Pusztavám
pusztazamor - Pusztazámor
putnok - Putnok
puski - Püski
puspokhatvan - Püspökhatvan
puspokladany - Püspökladány
puspokmolnari - Püspökmolnári
puspokszilagy - Püspökszilágy
rabacsanak - Rábacsanak
rabacsecseny - Rábacsécsény
rabagyarmat - Rábagyarmat
rabahidveg - Rábahídvég
rabakecol - Rábakecöl
rabapatona - Rábapatona
rabapaty - Rábapaty
rabapordany - Rábapordány
rabasebes - Rábasebes
rabaszentandras - Rábaszentandrás
rabaszentmihaly - Rábaszentmihály
rabaszentmiklos - Rábaszentmiklós
rabatamasi - Rábatamási
rabatottos - Rábatöttös
rabcakapi - Rábcakapi
racalmas - Rácalmás
rackeresztur - Ráckeresztúr
rackeve - Ráckeve
rad - Rád
radfalva - Rádfalva
radockolked - Rádóckölked
radostyan - Radostyán
ragaly - Ragály
rajka - Rajka
rakaca - Rakaca
rakacaszend - Rakacaszend
rakamaz - Rakamaz
rakoczibanya - Rákóczibánya
rakoczifalva - Rákóczifalva
rakocziujfalu - Rákócziújfalu
raksi - Ráksi
ramocsa - Ramocsa
ramocsahaza - Ramocsaháza
rapolt - Rápolt
raposka - Raposka
rasonysapberencs - Rásonysápberencs
ratka - Rátka
ratot - Rátót
ravazd - Ravazd
recsk - Recsk
rede - Réde
redics - Rédics
regec - Regéc
regenye - Regenye
regoly - Regöly
rem - Rém
remeteszolos - Remeteszőlős
repashuta - Répáshuta
repcelak - Répcelak
repceszemere - Répceszemere
repceszentgyorgy - Répceszentgyörgy
repcevis - Répcevis
resznek - Resznek
retalap - Rétalap
retkozberencs - Rétközberencs
retsag - Rétság
revfulop - Révfülöp
revleanyvar - Révleányvár
rezi - Rezi
ricse - Ricse
rigacs - Rigács
rigyac - Rigyác
rimoc - Rimóc
rinyabesenyo - Rinyabesenyő
rinyakovacsi - Rinyakovácsi
rinyaszentkiraly - Rinyaszentkirály
rinyaujlak - Rinyaújlak
rinyaujnep - Rinyaújnép
rohod - Rohod
romand - Románd
romhany - Romhány
romonya - Romonya
rozsafa - Rózsafa
rozsaly - Rozsály
rozsaszentmarton - Rózsaszentmárton
rojtokmuzsaj - Röjtökmuzsaj
ronok - Rönök
roszke - Röszke
rudabanya - Rudabánya
rudolftelep - Rudolftelep
rum - Rum
ruzsa - Ruzsa
sagujfalu - Ságújfalu
sagvar - Ságvár
sajobabony - Sajóbábony
sajoecseg - Sajóecseg
sajogalgoc - Sajógalgóc
sajohidveg - Sajóhídvég
sajoivanka - Sajóivánka
sajokapolna - Sajókápolna
sajokaza - Sajókaza
sajokeresztur - Sajókeresztúr
sajolad - Sajólád
sajolaszlofalva - Sajólászlófalva
sajomercse - Sajómercse
sajonemeti - Sajónémeti
sajooros - Sajóörös
sajopalfala - Sajópálfala
sajopetri - Sajópetri
sajopuspoki - Sajópüspöki
sajosenye - Sajósenye
sajoszentpeter - Sajószentpéter
sajoszoged - Sajószöged
sajovamos - Sajóvámos
sajovelezd - Sajóvelezd
sajtoskal - Sajtoskál
salfold - Salföld
salgotarjan - Salgótarján
salkoveskut - Salköveskút
salomvar - Salomvár
saly - Sály
samod - Sámod
samsonhaza - Sámsonháza
sand - Sand
sandorfalva - Sándorfalva
santos - Sántos
sap - Sáp
sarand - Sáránd
sarazsadany - Sárazsadány
sarbogard - Sárbogárd
saregres - Sáregres
sarfimizdo - Sárfimizdó
sarhida - Sárhida
sarisap - Sárisáp
sarkad - Sarkad
sarkadkeresztur - Sarkadkeresztúr
sarkeresztes - Sárkeresztes
sarkeresztur - Sárkeresztúr
sarkeszi - Sárkeszi
sarmellek - Sármellék
sarok - Sárok
sarosd - Sárosd
sarospatak - Sárospatak
sarpilis - Sárpilis
sarretudvari - Sárrétudvari
sarrod - Sarród
sarszentagota - Sárszentágota
sarszentlorinc - Sárszentlőrinc
sarszentmihaly - Sárszentmihály
sarud - Sarud
sarvar - Sárvár
sasd - Sásd
saska - Sáska
sata - Sáta
satoraljaujhely - Sátoraljaújhely
satorhely - Sátorhely
savoly - Sávoly
se - Sé
segesd - Segesd
selyeb - Selyeb
sellye - Sellye
semjen - Semjén
semjenhaza - Semjénháza
senye - Sénye
senyo - Sényő
seregelyes - Seregélyes
serenyfalva - Serényfalva
sersekszolos - Sérsekszőlős
sikator - Sikátor
siklos - Siklós
siklosbodony - Siklósbodony
siklosnagyfalu - Siklósnagyfalu
sima - Sima
simasag - Simaság
simonfa - Simonfa
simontornya - Simontornya
sioagard - Sióagárd
siofok - Siófok
siojut - Siójut
sirok - Sirok
sitke - Sitke
sobor - Sobor
sokoropatka - Sokorópátka
solt - Solt
soltszentimre - Soltszentimre
soltvadkert - Soltvadkert
soly - Sóly
solymar - Solymár
som - Som
somberek - Somberek
somlojeno - Somlójenő
somloszolos - Somlószőlős
somlovasarhely - Somlóvásárhely
somlovecse - Somlóvecse
somodor - Somodor
somogyacsa - Somogyacsa
somogyapati - Somogyapáti
somogyaracs - Somogyaracs
somogyaszalo - Somogyaszaló
somogybabod - Somogybabod
somogybukkosd - Somogybükkösd
somogycsicso - Somogycsicsó
somogydorocske - Somogydöröcske
somogyegres - Somogyegres
somogyfajsz - Somogyfajsz
somogygeszti - Somogygeszti
somogyharsagy - Somogyhárságy
somogyhatvan - Somogyhatvan
somogyjad - Somogyjád
somogymeggyes - Somogymeggyes
somogysamson - Somogysámson
somogysard - Somogysárd
somogysimonyi - Somogysimonyi
somogyszentpal - Somogyszentpál
somogyszil - Somogyszil
somogyszob - Somogyszob
somogytur - Somogytúr
somogyudvarhely - Somogyudvarhely
somogyvamos - Somogyvámos
somogyvar - Somogyvár
somogyviszlo - Somogyviszló
somogyzsitfa - Somogyzsitfa
somoskoujfalu - Somoskőújfalu
sonkad - Sonkád
soponya - Soponya
sopron - Sopron
sopronhorpacs - Sopronhorpács
sopronkovesd - Sopronkövesd
sopronnemeti - Sopronnémeti
sorkifalud - Sorkifalud
sorkikapolna - Sorkikápolna
sormas - Sormás
sorokpolany - Sorokpolány
soshartyan - Sóshartyán
soskut - Sóskút
sostofalva - Sóstófalva
sosvertike - Sósvertike
sotony - Sótony
sojtor - Söjtör
sopte - Söpte
sored - Söréd
sukoro - Sukoró
sumony - Sumony
sur - Súr
surd - Surd
sukosd - Sükösd
sulysap - Sülysáp
sumeg - Sümeg
sumegcsehi - Sümegcsehi
sumegpraga - Sümegprága
sutto - Süttő
szabadbattyan - Szabadbattyán
szabadegyhaza - Szabadegyháza
szabadhidveg - Szabadhídvég
szabadi - Szabadi
szabadkigyos - Szabadkígyós
szabadszallas - Szabadszállás
szabadszentkiraly - Szabadszentkirály
szabas - Szabás
szabolcs - Szabolcs
szabolcsbaka - Szabolcsbáka
szabolcsveresmart - Szabolcsveresmart
szada - Szada
szagy - Szágy
szajk - Szajk
szajla - Szajla
szajol - Szajol
szakacsi - Szakácsi
szakadat - Szakadát
szakald - Szakáld
szakaly - Szakály
szakcs - Szakcs
szakmar - Szakmár
szaknyer - Szaknyér
szakoly - Szakoly
szakony - Szakony
szakonyfalu - Szakonyfalu
szakszend - Szákszend
szalafo - Szalafő
szalanta - Szalánta
szalapa - Szalapa
szalaszend - Szalaszend
szalatnak - Szalatnak
szalka - Szálka
szalkszentmarton - Szalkszentmárton
szalmatercs - Szalmatercs
szalonna - Szalonna
szamosangyalos - Szamosangyalos
szamosbecs - Szamosbecs
szamosker - Szamoskér
szamossalyi - Szamossályi
szamostatarfalva - Szamostatárfalva
szamosujlak - Szamosújlak
szamosszeg - Szamosszeg
szanda - Szanda
szank - Szank
szantod - Szántód
szany - Szany
szapar - Szápár
szaporca - Szaporca
szar - Szár
szarasz - Szárász
szarazd - Szárazd
szarfold - Szárföld
szarliget - Szárliget
szarvas - Szarvas
szarvasgede - Szarvasgede
szarvaskend - Szarvaskend
szarvasko - Szarvaskő
szaszberek - Szászberek
szaszfa - Szászfa
szaszvar - Szászvár
szatmarcseke - Szatmárcseke
szatok - Szátok
szatta - Szatta
szatymaz - Szatymaz
szava - Szava
szazhalombatta - Százhalombatta
szebeny - Szebény
szecsenke - Szécsénke
szecseny - Szécsény
szecsenyfelfalu - Szécsényfelfalu
szecsisziget - Szécsisziget
szederkeny - Szederkény
szedres - Szedres
szeged - Szeged
szegerdo - Szegerdő
szeghalom - Szeghalom
szegi - Szegi
szegilong - Szegilong
szegvar - Szegvár
szekely - Székely
szekelyszabar - Székelyszabar
szekesfehervar - Székesfehérvár
szekkutas - Székkutas
szekszard - Szekszárd
szeleste - Szeleste
szeleveny - Szelevény
szello - Szellő
szemely - Szemely
szemenye - Szemenye
szemere - Szemere
szendehely - Szendehely
szendro - Szendrő
szendrolad - Szendrőlád
szenna - Szenna
szenta - Szenta
szentantalfa - Szentantalfa
szentbalazs - Szentbalázs
szentbekkalla - Szentbékkálla
szentborbas - Szentborbás
szentdenes - Szentdénes
szentdomonkos - Szentdomonkos
szente - Szente
szentegat - Szentegát
szentendre - Szentendre
szentes - Szentes
szentgal - Szentgál
szentgalosker - Szentgáloskér
szentgotthard - Szentgotthárd
szentgyorgyvar - Szentgyörgyvár
szentgyorgyvolgy - Szentgyörgyvölgy
szentimrefalva - Szentimrefalva
szentistvan - Szentistván
szentistvanbaksa - Szentistvánbaksa
szentjakabfa - Szentjakabfa
szentkatalin - Szentkatalin
szentkiraly - Szentkirály
szentkiralyszabadja - Szentkirályszabadja
szentkozmadombja - Szentkozmadombja
szentlaszlo - Szentlászló
szentliszlo - Szentliszló
szentlorinc - Szentlőrinc
szentlorinckata - Szentlőrinckáta
szentmargitfalva - Szentmargitfalva
szentmartonkata - Szentmártonkáta
szentpeterfa - Szentpéterfa
szentpeterfolde - Szentpéterfölde
szentpeterszeg - Szentpéterszeg
szentpeterur - Szentpéterúr
szenyer - Szenyér
szepetnek - Szepetnek
szerecseny - Szerecseny
szeremle - Szeremle
szerencs - Szerencs
szerep - Szerep
szergeny - Szergény
szigetbecse - Szigetbecse
szigetcsep - Szigetcsép
szigethalom - Szigethalom
szigetmonostor - Szigetmonostor
szigetszentmarton - Szigetszentmárton
szigetszentmiklos - Szigetszentmiklós
szigetujfalu - Szigetújfalu
szigetvar - Szigetvár
szigliget - Szigliget
szihalom - Szihalom
szijartohaza - Szijártóháza
szikszo - Szikszó
szil - Szil
szilagy - Szilágy
szilaspogony - Szilaspogony
szilsarkany - Szilsárkány
szilvagy - Szilvágy
szilvas - Szilvás
szilvasvarad - Szilvásvárad
szilvasszentmarton - Szilvásszentmárton
szin - Szin
szinpetri - Szinpetri
szirak - Szirák
szirmabesenyo - Szirmabesenyő
szob - Szob
szokolya - Szokolya
szolad - Szólád
szolnok - Szolnok
szombathely - Szombathely
szomod - Szomód
szomolya - Szomolya
szomor - Szomor
szorgalmatos - Szorgalmatos
szorosad - Szorosad
szoc - Szőc
szoce - Szőce
szod - Sződ
szodliget - Sződliget
szogliget - Szögliget
szoke - Szőke
szoked - Szőkéd
szokedencs - Szőkedencs
szolosardo - Szőlősardó
szolosgyorok - Szőlősgyörök
szoreny - Szörény
szucs - Szúcs
szuha - Szuha
szuhafo - Szuhafő
szuhakallo - Szuhakálló
szuhogy - Szuhogy
szuliman - Szulimán
szulok - Szulok
szurdokpuspoki - Szurdokpüspöki
szucsi - Szűcsi
szugy - Szügy
szur - Szűr
tab - Tab
tabajd - Tabajd
tabdi - Tabdi
taborfalva - Táborfalva
tac - Tác
tagyon - Tagyon
tahitotfalu - Tahitótfalu
takacsi - Takácsi
takos - Tákos
taksony - Taksony
taktabaj - Taktabáj
taktaharkany - Taktaharkány
taktakenez - Taktakenéz
taktaszada - Taktaszada
taliandorogd - Taliándörögd
tallya - Tállya
tamasi - Tamási
tanakajd - Tanakajd
tap - Táp
tapiobicske - Tápióbicske
tapiogyorgye - Tápiógyörgye
tapiosag - Tápióság
tapioszecso - Tápiószecső
tapioszele - Tápiószele
tapioszentmarton - Tápiószentmárton
tapioszolos - Tápiószőlős
taplanszentkereszt - Táplánszentkereszt
tapolca - Tapolca
tapsony - Tapsony
tapszentmiklos - Tápszentmiklós
tar - Tar
tarany - Tarany
tarcal - Tarcal
tard - Tard
tardona - Tardona
tardos - Tardos
tarhos - Tarhos
tarjan - Tarján
tarjanpuszta - Tarjánpuszta
tarkany - Tárkány
tarnabod - Tarnabod
tarnalelesz - Tarnalelesz
tarnamera - Tarnaméra
tarnaors - Tarnaörs
tarnaszentmaria - Tarnaszentmária
tarnaszentmiklos - Tarnaszentmiklós
tarnazsadany - Tarnazsadány
tarnok - Tárnok
tarnokreti - Tárnokréti
tarpa - Tarpa
tarros - Tarrós
taska - Táska
tass - Tass
taszar - Taszár
tat - Tát
tata - Tata
tatabanya - Tatabánya
tatahaza - Tataháza
tatarszentgyorgy - Tatárszentgyörgy
tazlar - Tázlár
teglas - Téglás
tekenye - Tekenye
tekes - Tékes
teklafalu - Teklafalu
telekes - Telekes
telekgerendas - Telekgerendás
teleki - Teleki
telki - Telki
telkibanya - Telkibánya
tengelic - Tengelic
tengeri - Tengeri
tengod - Tengőd
tenk - Tenk
tenyo - Tényő
tepe - Tépe
terem - Terem
tereny - Terény
tereske - Tereske
teresztenye - Teresztenye
terpes - Terpes
tes - Tés
tesa - Tésa
tesenfa - Tésenfa
teseny - Téseny
teskand - Teskánd
tet - Tét
tetetlen - Tetétlen
tevel - Tevel
tibolddaroc - Tibolddaróc
tiborszallas - Tiborszállás
tihany - Tihany
tikos - Tikos
tilaj - Tilaj
timar - Timár
tinnye - Tinnye
tiszaadony - Tiszaadony
tiszaalpar - Tiszaalpár
tiszababolna - Tiszabábolna
tiszabecs - Tiszabecs
tiszabercel - Tiszabercel
tiszabezded - Tiszabezdéd
tiszabo - Tiszabő
tiszabura - Tiszabura
tiszacsecse - Tiszacsécse
tiszacsege - Tiszacsege
tiszacsermely - Tiszacsermely
tiszadada - Tiszadada
tiszaderzs - Tiszaderzs
tiszadob - Tiszadob
tiszadorogma - Tiszadorogma
tiszaeszlar - Tiszaeszlár
tiszafoldvar - Tiszaföldvár
tiszafured - Tiszafüred
tiszagyenda - Tiszagyenda
tiszagyulahaza - Tiszagyulaháza
tiszaigar - Tiszaigar
tiszainoka - Tiszainoka
tiszajeno - Tiszajenő
tiszakanyar - Tiszakanyár
tiszakarad - Tiszakarád
tiszakecske - Tiszakécske
tiszakerecseny - Tiszakerecseny
tiszakeszi - Tiszakeszi
tiszakorod - Tiszakóród
tiszakurt - Tiszakürt
tiszaladany - Tiszaladány
tiszalok - Tiszalök
tiszaluc - Tiszalúc
tiszamogyoros - Tiszamogyorós
tiszanagyfalu - Tiszanagyfalu
tiszanana - Tiszanána
tiszaors - Tiszaörs
tiszapalkonya - Tiszapalkonya
tiszapuspoki - Tiszapüspöki
tiszarad - Tiszarád
tiszaroff - Tiszaroff
tiszasas - Tiszasas
tiszasuly - Tiszasüly
tiszaszalka - Tiszaszalka
tiszaszentimre - Tiszaszentimre
tiszaszentmarton - Tiszaszentmárton
tiszasziget - Tiszasziget
tiszaszolos - Tiszaszőlős
tiszatardos - Tiszatardos
tiszatarjan - Tiszatarján
tiszatelek - Tiszatelek
tiszatenyo - Tiszatenyő
tiszaug - Tiszaug
tiszaujvaros - Tiszaújváros
tiszavalk - Tiszavalk
tiszavarkony - Tiszavárkony
tiszavasvari - Tiszavasvári
tiszavid - Tiszavid
tisztaberek - Tisztaberek
tivadar - Tivadar
toalmas - Tóalmás
tofalu - Tófalu
tofej - Tófej
tofu - Tófű
tokaj - Tokaj
tokod - Tokod
tokodaltaro - Tokodaltáró
tokorcs - Tokorcs
tolcsva - Tolcsva
told - Told
tolmacs - Tolmács
tolna - Tolna
tolnanemedi - Tolnanémedi
tomajmonostora - Tomajmonostora
tomor - Tomor
tompa - Tompa
tompaladony - Tompaládony
tordas - Tordas
tormafolde - Tormafölde
tormas - Tormás
tormasliget - Tormásliget
tornabarakony - Tornabarakony
tornakapolna - Tornakápolna
tornanadaska - Tornanádaska
tornaszentandras - Tornaszentandrás
tornaszentjakab - Tornaszentjakab
tornyiszentmiklos - Tornyiszentmiklós
tornyosnemeti - Tornyosnémeti
tornyospalca - Tornyospálca
torony - Torony
torvaj - Torvaj
toszeg - Tószeg
totkomlos - Tótkomlós
totszentgyorgy - Tótszentgyörgy
totszentmarton - Tótszentmárton
totszerdahely - Tótszerdahely
totujfalu - Tótújfalu
totvazsony - Tótvázsony
tok - Tök
tokol - Tököl
toltestava - Töltéstava
tomord - Tömörd
tomorkeny - Tömörkény
torokbalint - Törökbálint
torokkoppany - Törökkoppány
torokszentmiklos - Törökszentmiklós
tortel - Törtel
tottos - Töttös
trizs - Trizs
tunyogmatolcs - Tunyogmatolcs
tura - Tura
turistvandi - Túristvándi
turkeve - Túrkeve
turony - Túrony
turricse - Túrricse
tuzser - Tuzsér
turje - Türje
tuskevar - Tüskevár
tyukod - Tyukod
udvar - Udvar
udvari - Udvari
ugod - Ugod
ujbarok - Újbarok
ujcsanalos - Újcsanálos
ujdombrad - Újdombrád
ujfeherto - Újfehértó
ujhartyan - Újhartyán
ujiraz - Újiráz
ujireg - Újireg
ujkenez - Újkenéz
ujker - Újkér
ujkigyos - Újkígyós
ujlengyel - Újlengyel
ujleta - Újléta
ujlorincfalva - Újlőrincfalva
ujpetre - Újpetre
ujronafo - Újrónafő
ujsolt - Újsolt
ujszalonta - Újszalonta
ujszasz - Újszász
ujszentivan - Újszentiván
ujszentmargita - Újszentmargita
ujszilvas - Újszilvás
ujtelek - Újtelek
ujtikos - Újtikos
ujudvar - Újudvar
ujvarfalva - Újvárfalva
ukk - Ukk
und - Und
uny - Úny
uppony - Uppony
ura - Ura
uraiujfalu - Uraiújfalu
urhida - Úrhida
uri - Úri
urkut - Úrkút
uszka - Uszka
uszod - Uszód
uzsa - Uzsa
ulles - Üllés
ullo - Üllő
urom - Üröm
vac - Vác
vacduka - Vácduka
vacegres - Vácegres
vachartyan - Váchartyán
vackisujfalu - Váckisújfalu
vacratot - Vácrátót
vacszentlaszlo - Vácszentlászló
vadna - Vadna
vadosfa - Vadosfa
vag - Vág
vagashuta - Vágáshuta
vaja - Vaja
vajdacska - Vajdácska
vajszlo - Vajszló
vajta - Vajta
val - Vál
valko - Valkó
valkonya - Valkonya
vallaj - Vállaj
vallus - Vállus
vamosatya - Vámosatya
vamoscsalad - Vámoscsalád
vamosgyork - Vámosgyörk
vamosmikola - Vámosmikola
vamosoroszi - Vámosoroszi
vamospercs - Vámospércs
vamosujfalu - Vámosújfalu
vamosszabadi - Vámosszabadi
vancsod - Váncsod
vanyarc - Vanyarc
vanyola - Vanyola
varad - Várad
varalja - Váralja
varaszlo - Varászló
varaszo - Váraszó
varbalog - Várbalog
varbo - Varbó
varboc - Varbóc
varda - Várda
vardomb - Várdomb
varfolde - Várfölde
varga - Varga
vargesztes - Várgesztes
varkeszo - Várkesző
varong - Várong
varosfold - Városföld
varoslod - Városlőd
varpalota - Várpalota
varsad - Varsád
varsany - Varsány
varvolgy - Várvölgy
vasad - Vasad
vasalja - Vasalja
vasarosbec - Vásárosbéc
vasarosdombo - Vásárosdombó
vasarosfalu - Vásárosfalu
vasarosmiske - Vásárosmiske
vasarosnameny - Vásárosnamény
vasasszonyfa - Vasasszonyfa
vasboldogasszony - Vasboldogasszony
vasegerszeg - Vasegerszeg
vashosszufalu - Vashosszúfalu
vaskeresztes - Vaskeresztes
vaskut - Vaskút
vasmegyer - Vasmegyer
vaspor - Vaspör
vassurany - Vassurány
vasvar - Vasvár
vaszar - Vaszar
vaszoly - Vászoly
vasszecseny - Vasszécseny
vasszentmihaly - Vasszentmihály
vasszilvagy - Vasszilvágy
vat - Vát
vatta - Vatta
vazsnok - Vázsnok
vecs - Vécs
vecses - Vecsés
vegegyhaza - Végegyháza
vejti - Vejti
vekeny - Vékény
vekerd - Vekerd
velem - Velem
velemer - Velemér
velence - Velence
veleny - Velény
vemend - Véménd
venek - Vének
vep - Vép
vereb - Vereb
veresegyhaz - Veresegyház
veroce - Verőce
verpelet - Verpelét
verseg - Verseg
versend - Versend
vertesacsa - Vértesacsa
vertesboglar - Vértesboglár
verteskethely - Vérteskethely
vertessomlo - Vértessomló
vertestolna - Vértestolna
vertesszolos - Vértesszőlős
vese - Vése
veszkeny - Veszkény
veszprem - Veszprém
veszpremfajsz - Veszprémfajsz
veszpremgalsa - Veszprémgalsa
veszpremvarsany - Veszprémvarsány
veszto - Vésztő
vezseny - Vezseny
vid - Vid
vigantpetend - Vigántpetend
villany - Villány
villanykovesd - Villánykövesd
vilmany - Vilmány
vilonya - Vilonya
vilyvitany - Vilyvitány
vinar - Vinár
vindornyafok - Vindornyafok
vindornyalak - Vindornyalak
vindornyaszolos - Vindornyaszőlős
visegrad - Visegrád
visnye - Visnye
visonta - Visonta
viss - Viss
visz - Visz
viszak - Viszák
viszlo - Viszló
visznek - Visznek
vitnyed - Vitnyéd
vizvar - Vízvár
vizslas - Vizslás
vizsoly - Vizsoly
vokany - Vokány
vonyarcvashegy - Vonyarcvashegy
vockond - Vöckönd
volcsej - Völcsej
vonock - Vönöck
vorosto - Vöröstó
vors - Vörs
zabar - Zabar
zador - Zádor
zadorfalva - Zádorfalva
zagyvarekas - Zagyvarékas
zagyvaszanto - Zagyvaszántó
zahony - Záhony
zajk - Zajk
zajta - Zajta
zakany - Zákány
zakanyfalu - Zákányfalu
zakanyszek - Zákányszék
zala - Zala
zalaapati - Zalaapáti
zalabaksa - Zalabaksa
zalaber - Zalabér
zalaboldogfa - Zalaboldogfa
zalacsany - Zalacsány
zalacseb - Zalacséb
zalaegerszeg - Zalaegerszeg
zalaerdod - Zalaerdőd
zalagyomoro - Zalagyömörő
zalahalap - Zalahaláp
zalahashagy - Zalaháshágy
zalaigrice - Zalaigrice
zalaistvand - Zalaistvánd
zalakaros - Zalakaros
zalakomar - Zalakomár
zalakoveskut - Zalaköveskút
zalalovo - Zalalövő
zalameggyes - Zalameggyes
zalamerenye - Zalamerenye
zalasarszeg - Zalasárszeg
zalaszabar - Zalaszabar
zalaszanto - Zalaszántó
zalaszegvar - Zalaszegvár
zalaszentbalazs - Zalaszentbalázs
zalaszentgrot - Zalaszentgrót
zalaszentgyorgy - Zalaszentgyörgy
zalaszentivan - Zalaszentiván
zalaszentjakab - Zalaszentjakab
zalaszentlaszlo - Zalaszentlászló
zalaszentlorinc - Zalaszentlőrinc
zalaszentmarton - Zalaszentmárton
zalaszentmihaly - Zalaszentmihály
zalaszombatfa - Zalaszombatfa
zalata - Zaláta
zalatarnok - Zalatárnok
zalaujlak - Zalaújlak
zalavar - Zalavár
zalaveg - Zalavég
zalkod - Zalkod
zamardi - Zamárdi
zamoly - Zámoly
zanka - Zánka
zarank - Zaránk
zavod - Závod
zebecke - Zebecke
zebegeny - Zebegény
zemplenagard - Zemplénagárd
zengovarkony - Zengővárkony
zichyujfalu - Zichyújfalu
zics - Zics
ziliz - Ziliz
zimany - Zimány
zirc - Zirc
zok - Zók
zomba - Zomba
zubogy - Zubogy
zsadany - Zsadány
zsaka - Zsáka
zsambek - Zsámbék
zsambok - Zsámbok
zsana - Zsana
zsarolyan - Zsarolyán
zsebehaza - Zsebeháza
zsedeny - Zsédeny
zselickisfalud - Zselickisfalud
zselickislak - Zselickislak
zselicszentpal - Zselicszentpál
zsennye - Zsennye
zsira - Zsira
zsombo - Zsombó
zsujta - Zsujta
zsurk - Zsurk
 - 